achten auf - dávat pozor
anfangen mit - začít s
ankommen auf - záležet na
antworten auf - odpovědět na
arbeiten an - pracovat na
aufhören mit - přestat s
aufpassen auf - dávat pozor
ausgeben für - utrácet za
beraten über - radit se o
berichten über - informovat o
besprechen mit - probrat s
bestehen aus - skládat se z
bitten um - poprosit o
denken an - myslet na
diskutieren über - diskutovat o
einladen zu - pozvat k
erkennen an - poznat podle
ersetzen durch - nahradit za
erzählen von - vyprávět o
fragen nach - ptát se na
führen mit - vést s
führen zu - vést k
gehen um / sich handeln um - jednat se o
gehören zu - patřit k
glauben an - věřit v
gratulieren zu - gratulovat k
halten für - považovat za
halten von - myslet si o
handeln von - pojednávat o
hoffen auf - doufat v
hören von - slyšet o
investieren in - investovat do
kommen auf - přijít na
kommen zu - dojít k
kämpfen für - bojovat za
kämpfen gegen - bojovat proti
leiden unter - trpět kvůli
liegen an - záležet na
lächeln über / lachen über - smát se
meinen zu - myslet si o
mischen mit - smíchat s
nachdenken über - přemýšlet o
passen zu - hodit se k
protestieren gegen - protestovat proti
reagieren auf - reagovat na
rechnen mit - počítat s
riechen nach - vonět po
rufen nach - volat po
schimpfen mit - nadávat někomu
schimpfen über - nadávat na
schmecken nach - chutnat po
schützen vor - chránit před
sehen nach - zkontrolovat
sich beschweren über - stěžovat si
sich beschäftigen mit - zabývat se
sich bewerben um - ucházet se o
sich beziehen auf - odkazovat se
sich durchsetzen gegen - prosadit se
sich einsetzen für - zasadit se
sich engagieren für - angažovat se
sich entscheiden für - rozhodnout se
sich entschuldigen für - omluvit se
sich entwickeln zu - vyvinout se
sich erholen von - zotavit se
sich erinnern an - vzpomenout si
sich freuen auf - těšit se
sich freuen über - mít radost
sich fürchten vor - bát se
sich gewöhnen an - zvyknout si
sich informieren über - informovat se
sich interessieren für - zajímat se
sich konzentrieren auf - soustředit se
sich kümmern um - starat se
sich streiten mit - hádat se
sich treffen mit - sejít se
sich trennen von - rozejít se
sich unterscheiden von - lišit se
sich verabschieden von - rozloučit se
sich verlassen auf - spolehnout se
sich verstehen mit - rozumět si
sich vorbereiten auf - připravit se
sich zusammensetzen aus - skládat se
sich ärgern über - zlobit se
sprechen mit - mluvit s
sprechen über / reden von - mluvit o
stellen auf - nastavit na
stimmen für - hlasovat pro
stimmen gegen - hlasovat proti
streiten über - hádat se
teilnehmen an - účastnit se
telefonieren mit - telefonovat s
träumen von - snít o
tun für - dělat pro
tun gegen - dělat proti
verbinden mit - spojit s
vergleichen mit - srovnat s
verzichten auf - obejít se
warnen vor - varovat před
warten auf - čekat na
wirken auf - působit na
wissen von - vědět o
wählen zu - zvolit za
zusammenarbeiten mit - spolupracovat s
ändern an - měnit na
